13 13
11 12
11 13
11 14
1 1 21 1 1 25
2 1 1 1 1 1 1 1 1 1 1 1 1 4 1 01 1 1 1 1 1 1 1 1 1 1 3
5 19 18 18 18 18 18 18 18 18 18 18 18 5 18 18 18 18 18 18 18 18 18 18 18 19 5
5 18 2 1 1 1 3 18 2 1 1 3 18 5 18 02 1 1 3 18 2 1 1 1 3 18 5
5 18 5 0 0 0 5 18 5 0 0 5 18 5 18 05 0 0 5 18 5 0 0 0 5 18 5
5 18 6 1 1 1 7 18 6 1 1 7 18 9 18 06 1 1 7 18 6 1 1 1 7 18 5
5 18 18 18 18 18 18 18 18 18 18 18 18 18 18 18 18 18 18 18 18 18 18 18 18 18 5
5 18 11 1 1 1 12 18 10 18 11 1 1 04 1 1 12 18 10 18 11 1 1 1 12 18 5
5 18 18 18 18 18 18 18 05 18 18 18 18 05 18 18 18 18 05 18 18 18 18 18 18 18 5
6 1 01 1 1 1 03 18 13 1 12 18 18 09 18 18 11 1 14 18 02 1 1 1 01 1 7
0 0 00 0 0 0 05 18 05 18 18 18 18 18 18 18 18 18 05 18 05 0 0 0 00 0 0
1 1 01 1 1 1 07 18 09 18 18 2 1 17 1 3 18 18 09 18 06 1 1 1 01 1 1
18 18 18 18 18 18 18 18 18 18 18 5 0 00 0 5 18 18 18 18 18 18 18 18 18 18 18
1 1 01 1 1 1 03 18 10 18 18 6 1 01 1 7 18 18 10 18 02 1 1 1 01 1 1
0 0 00 0 0 0 05 18 05 18 18 18 18 18 18 18 18 18 05 18 05 0 0 0 00 0 0
2 1 01 1 1 1 07 18 13 1 12 18 18 10 18 18 11 1 14 18 06 1 1 1 01 1 3
5 18 18 18 18 18 18 18 05 18 18 18 18 05 18 18 18 18 05 18 18 18 18 18 18 18 5
5 18 11 1 1 1 12 18 09 18 11 1 1 08 1 1 12 18 09 18 11 1 1 1 12 18 5
5 18 18 18 18 18 18 18 18 18 18 18 18 18 18 18 18 18 18 18 18 18 18 18 18 18 5
5 18 2 1 1 1 3 18 2 1 1 3 18 10 18 02 1 1 3 18 2 1 1 1 3 18 5
5 18 5 0 0 0 5 18 5 0 0 5 18 5 18 05 0 0 5 18 5 0 0 0 5 18 5
5 18 6 1 1 1 7 18 6 1 1 7 18 5 18 06 1 1 7 18 6 1 1 1 7 18 5
5 19 18 18 18 18 18 18 18 18 18 18 18 5 18 18 18 18 18 18 18 18 18 18 18 19 5
6 1 1 1 1 1 1 1 1 1 1 1 1 8 1 01 1 1 1 1 1 1 1 1 1 1 7