11 6
8 5
8 5
8 7
1 1 1 18 1 12
2 1 1 1 1 1 1 1 1 1 1 1 1 3
5 19 18 18 18 18 18 18 18 18 18 18 19 5
5 18 16 18 16 18 11 12 18 16 18 16 18 5
5 18 18 18 18 18 18 18 18 18 18 18 18 5
7 0 0 11 1 1 1 1 1 1 12 0 0 6
18 18 18 18 18 18 18 18 18 18 18 18 18 18
3 18 10 18 18 18 18 18 18 18 18 10 18 2
5 18 5 18 2 1 17 1 3 18 18 5 18 5
5 18 5 18 5 0 0 0 5 18 18 5 18 5
7 18 9 18 6 1 1 1 7 18 18 9 18 6
18 18 18 18 18 18 18 18 18 18 18 18 18 18
3 18 2 3 18 0 0 0 0 18 2 3 18 2
5 18 5 5 18 18 18 18 18 18 5 5 18 5
5 18 5 5 18 2 1 1 3 18 5 5 18 5
5 18 6 7 18 6 3 2 7 18 6 7 18 5
5 18 18 18 18 18 5 5 18 18 18 18 18 5
5 18 2 1 3 18 5 5 18 2 1 3 18 5
5 18 6 1 7 18 6 7 18 6 1 7 18 5
5 19 18 18 18 18 18 18 18 18 18 18 19 5
6 1 1 1 1 1 1 1 1 1 1 1 1 7