18 3
10 7
10 8
10 9
1 1 1 15 23 1
2 1 1 1 1 1 1 7 0 6 1 1 1 1 1 1 3
5 19 18 18 18 18 18 18 18 18 18 18 18 18 18 19 5
5 18 2 3 18 18 18 18 18 18 18 18 18 2 3 18 5
5 18 5 5 18 18 18 18 10 18 18 18 18 5 5 18 5
5 18 5 5 18 18 11 1 15 1 12 18 18 5 5 18 5
5 18 5 5 18 18 18 18 5 18 18 18 18 5 5 18 5
5 18 5 5 18 18 18 18 5 18 18 18 18 5 5 18 5
5 18 6 7 18 18 18 11 8 12 18 18 18 6 7 18 5
5 18 18 18 18 18 18 0 0 0 18 18 18 18 18 18 5
6 1 1 3 18 18 2 1 17 1 3 18 18 2 1 1 7
0 0 0 5 18 18 5 0 0 0 5 18 18 5 0 0 0
1 1 1 7 18 18 13 1 1 1 14 18 18 6 1 1 1
0 0 0 18 18 18 5 0 0 0 5 18 18 18 0 0 0
2 1 12 18 18 18 5 2 1 3 5 18 18 18 11 1 3
5 18 18 18 18 18 5 5 19 5 5 18 18 18 18 18 5
5 18 11 1 1 1 8 7 18 6 8 1 1 1 12 18 5
5 18 18 18 18 18 18 18 18 18 18 18 18 18 18 18 5
5 18 11 1 1 1 1 1 4 1 1 1 1 1 12 18 5
5 19 18 18 18 18 18 18 5 18 18 18 18 18 18 19 5
5 18 2 4 4 4 3 18 5 18 2 4 4 4 3 18 5
5 18 13 15 15 15 14 18 9 18 13 15 15 15 14 18 5
5 18 13 15 15 15 14 18 18 18 13 15 15 15 14 18 5
5 18 6 8 8 8 7 18 19 18 6 8 8 8 7 18 5
5 18 18 18 18 18 18 18 18 18 18 18 18 18 18 18 5
6 1 1 1 1 1 1 3 0 2 1 1 1 1 1 1 7